17 22
S.....................
.XXXXXXXXXXXXXXXX.X.X.
.X.........K....XK....
.XXXXXX.XXXXXXX..X.XX.
..............XX.X.XXG
.XXXXXX.XXXXXXX..X.XX.
.X..............X.G...
.XXXXXXXXXXXXXXXXX.XX.
...................XX.
.XXXXXXXXXXXXXXXXX.XX.
.X........K...K.X..XXG
.XXXXXX.XXXXXXX..XGXX.
........K.....XX.X.XX.
.XXXXXX.XXXXXXXG.X.XX.
.X........K...K.X..G..
.XXXXXXXXXXXXXXXX.X.X
.....................T
