17 22
S.....................
.XXXXXXXXXXXXXXXX.....
.X.........K....XKX...
.XXXXXX..XXXXXX..X....
..............X..X....
.XXXXXX..XXXXXX..X..G.
.X..............X..G..
.XXXXXXXXXXXXXXXXX..X.
.....................X
.XXXXXXXXXXXXXXXXX..X.
.X........K...K.X..XG.
.XXXXXX..XXXXXX..XG...
........K.....X..X....
.XXXXXX..XXXXXX..X..G.
.X........K...K.X..G..
.XXXXXXXXXXXXXXXXX....
.....................T
