28 17
SKKKKKKKKKKKKKKKKKKKKKKKKKKK
KXXXXXXKXXXXXXXXXXXXKXXXXXXK
KKKKKKXKKKKKKKKKKKKKKXKKKKKK
KXXXXKXKXXXXXKKXXXXXKXKXXXXK
KKKKXKXKKKKKKKKKKKKKKXKXKKKK
KXXKXKXKXXXXXKKXXXXXKXKXKXXK
KKKKXKKKKKKKKKKKKKKKKKKXKKKK
KXXKXKXKXKXXXKKXXXKXKXKXKXXK
KKKKKKXKXKXKKGGKKXKXKXKKKKKK
KXXKXKXKXKXKKKKKKXKXKXKXKXXK
KXXKXKXKXXXXXXXXXXXXKXKXKXXK
KKKKXKKKKKKKKKKKKKKKKKKXKKKK
KXXKXKXKXXXXXKKXXXXXKXKXKXXK
KKKKXKXKKKKKKKKKKKKKKXKXKKKK
KXXXXKXKXXXXXKKXXXXXKXKXXXXK
KKKKKKXKKKKKKKKKKKKKKXKKKKKK
KXXXXXXKXXXXXXXXXXXXKXXXXXXK
KKKKKKKKKKKKKKKKKKKKKKKKKKKT
